Rk,Player,Pos,Age,Tm,G,GS,MP,FG,FGA,FG%,3P,3PA,3P%,2P,2PA,2P%,eFG%,FT,FTA,FT%,ORB,DRB,TRB,AST,STL,BLK,TOV,PF,PTS
1,Precious Achiuwa,PF,21,MIA,61,4,737,124,228,0.544,0,1,0,124,227,0.546,0.544,56,110,0.509,73,135,208,29,20,28,43,91,304
2,Jaylen Adams,PG,24,MIL,7,0,18,1,8,0.125,0,2,0,1,6,0.167,0.125,0,0,,0,3,3,2,0,0,0,1,2
3,Steven Adams,C,27,NOP,58,58,1605,189,308,0.614,0,3,0,189,305,0.62,0.614,60,135,0.444,213,301,514,111,54,38,78,113,438
4,Bam Adebayo,C,23,MIA,64,64,2143,456,800,0.57,2,8,0.25,454,792,0.573,0.571,283,354,0.799,142,431,573,346,75,66,169,145,1197
5,LaMarcus Aldridge,C,35,TOT,26,23,674,140,296,0.473,31,80,0.388,109,216,0.505,0.525,41,47,0.872,19,99,118,49,11,29,27,47,352
5,LaMarcus Aldridge,C,35,SAS,21,18,544,115,248,0.464,27,75,0.36,88,173,0.509,0.518,31,37,0.838,17,77,94,36,8,18,20,36,288
5,LaMarcus Aldridge,C,35,BRK,5,5,130,25,48,0.521,4,5,0.8,21,43,0.488,0.563,10,10,1,2,22,24,13,3,11,7,11,64
6,Ty-Shon Alexander,SG,22,PHO,15,0,47,3,12,0.25,2,9,0.222,1,3,0.333,0.333,1,2,0.5,2,8,10,6,0,1,3,2,9
7,Nickeil Alexander-Walker,SG,22,NOP,46,13,1007,192,458,0.419,76,219,0.347,116,239,0.485,0.502,48,66,0.727,13,131,144,102,47,22,69,88,508
8,Grayson Allen,SG,25,MEM,50,38,1259,173,414,0.418,107,274,0.391,66,140,0.471,0.547,79,91,0.868,19,141,160,108,46,8,48,71,532
9,Jarrett Allen,C,22,TOT,63,45,1864,298,482,0.618,6,19,0.316,292,463,0.631,0.624,204,290,0.703,196,435,631,106,32,90,100,96,806
9,Jarrett Allen,C,22,BRK,12,5,320,44,65,0.677,0,0,,44,65,0.677,0.677,46,61,0.754,38,87,125,20,7,19,22,21,134
9,Jarrett Allen,C,22,CLE,51,40,1544,254,417,0.609,6,19,0.316,248,398,0.623,0.616,158,229,0.69,158,348,506,86,25,71,78,75,672
10,Al-Farouq Aminu,PF,30,TOT,23,14,434,38,99,0.384,8,37,0.216,30,62,0.484,0.424,18,22,0.818,22,88,110,31,19,9,28,29,102
10,Al-Farouq Aminu,PF,30,ORL,17,14,367,36,89,0.404,7,31,0.226,29,58,0.5,0.444,14,17,0.824,20,71,91,29,17,9,25,22,93
10,Al-Farouq Aminu,PF,30,CHI,6,0,67,2,10,0.2,1,6,0.167,1,4,0.25,0.25,4,5,0.8,2,17,19,2,2,0,3,7,9
11,Kyle Anderson,PF,27,MEM,69,69,1887,308,658,0.468,94,261,0.36,214,397,0.539,0.54,144,184,0.783,52,344,396,250,84,57,86,120,854
12,Giannis Antetokounmpo,PF,26,MIL,61,61,2013,626,1100,0.569,67,221,0.303,559,879,0.636,0.6,398,581,0.685,97,574,671,357,72,73,207,168,1717
13,Kostas Antetokounmpo,PF,23,LAL,15,0,56,3,10,0.3,0,0,,3,10,0.3,0.3,6,13,0.462,4,15,19,1,2,4,11,8,12
14,Thanasis Antetokounmpo,SF,28,MIL,57,3,551,67,137,0.489,7,29,0.241,60,108,0.556,0.515,25,49,0.51,54,70,124,46,22,10,43,74,166
15,Carmelo Anthony,PF,36,POR,69,3,1690,327,777,0.421,133,325,0.409,194,452,0.429,0.506,137,154,0.89,32,182,214,104,46,38,61,144,924
16,Cole Anthony,PG,20,ORL,47,34,1273,219,552,0.397,58,172,0.337,161,380,0.424,0.449,109,131,0.832,38,183,221,192,30,18,106,98,605
17,OG Anunoby,SF,23,TOR,43,43,1433,249,519,0.48,104,261,0.398,145,258,0.562,0.58,80,102,0.784,54,183,237,94,66,32,75,114,682
18,Ryan Arcidiacono,PG,26,CHI,44,0,450,49,117,0.419,25,67,0.373,24,50,0.48,0.526,13,20,0.65,5,62,67,56,9,0,10,47,136
19,Trevor Ariza,SF,35,MIA,30,27,841,99,241,0.411,50,143,0.35,49,98,0.5,0.515,34,44,0.773,27,117,144,55,31,18,21,55,282
20,D.J. Augustin,PG,33,TOT,57,12,1129,135,343,0.394,83,217,0.382,52,126,0.413,0.515,85,94,0.904,20,74,94,188,28,1,65,56,438
20,D.J. Augustin,PG,33,MIL,37,6,713,71,192,0.37,49,129,0.38,22,63,0.349,0.497,36,40,0.9,11,39,50,110,20,1,34,33,227
20,D.J. Augustin,PG,33,HOU,20,6,416,64,151,0.424,34,88,0.386,30,63,0.476,0.536,49,54,0.907,9,35,44,78,8,0,31,23,211
21,Deni Avdija,SF,20,WAS,54,32,1257,130,312,0.417,53,168,0.315,77,144,0.535,0.502,29,45,0.644,22,240,262,63,32,15,33,140,342
22,Deandre Ayton,C,22,PHO,69,69,2115,430,687,0.626,4,20,0.2,426,667,0.639,0.629,133,173,0.769,228,499,727,99,41,81,103,196,997
23,Udoka Azubuike,C,21,UTA,15,0,57,4,9,0.444,0,0,,4,9,0.444,0.444,8,10,0.8,4,9,13,0,1,4,3,9,16
24,Dwayne Bacon,SG,25,ORL,72,50,1853,292,726,0.402,59,207,0.285,233,519,0.449,0.443,145,176,0.824,31,193,224,93,45,5,46,103,788
25,Marvin Bagley III,PF,21,SAC,43,42,1112,247,490,0.504,37,108,0.343,210,382,0.55,0.542,77,134,0.575,106,212,318,43,21,21,59,100,608
26,LaMelo Ball,PG,19,CHO,51,31,1469,293,672,0.436,92,261,0.352,201,411,0.489,0.504,125,165,0.758,63,239,302,313,81,18,145,136,803
27,Lonzo Ball,PG,23,NOP,55,55,1747,290,700,0.414,172,455,0.378,118,245,0.482,0.537,50,64,0.781,33,230,263,316,82,31,123,103,802
28,Mo Bamba,C,22,ORL,46,5,725,142,301,0.472,38,118,0.322,104,183,0.568,0.535,45,66,0.682,76,189,265,35,14,58,36,87,367
29,Desmond Bane,SG,22,MEM,68,17,1519,234,499,0.469,117,271,0.432,117,228,0.513,0.586,40,49,0.816,31,179,210,118,41,16,59,125,625
30,Harrison Barnes,PF,28,SAC,58,58,2102,319,642,0.497,100,256,0.391,219,386,0.567,0.575,195,235,0.83,64,321,385,201,43,11,93,75,933
31,RJ Barrett,SG,20,NYK,72,72,2511,467,1060,0.441,124,309,0.401,343,751,0.457,0.499,206,276,0.746,68,346,414,217,53,20,139,188,1264
32,Will Barton,SF,30,DEN,56,52,1736,259,608,0.426,98,257,0.381,161,351,0.459,0.507,95,121,0.785,39,187,226,181,50,23,96,95,711
33,Keita Bates-Diop,SF,25,SAS,30,0,245,30,67,0.448,5,17,0.294,25,50,0.5,0.485,14,21,0.667,9,40,49,12,11,5,7,11,79
34,Nicolas Batum,SF,32,LAC,67,38,1835,191,412,0.464,110,272,0.404,81,140,0.579,0.597,48,58,0.828,50,266,316,148,69,37,53,102,540
35,Aron Baynes,C,34,TOR,53,31,980,134,304,0.441,27,103,0.262,107,201,0.532,0.485,29,41,0.707,87,186,273,47,17,23,46,119,324
36,Kent Bazemore,SF,31,GSW,67,18,1333,176,392,0.449,75,184,0.408,101,208,0.486,0.545,54,78,0.692,26,203,229,108,69,33,82,158,481
37,Darius Bazley,PF,20,OKC,55,55,1714,273,690,0.396,83,286,0.29,190,404,0.47,0.456,125,178,0.702,51,345,396,99,29,25,122,60,754
38,Bradley Beal,SG,27,WAS,60,60,2147,670,1382,0.485,130,373,0.349,540,1009,0.535,0.532,408,459,0.889,72,211,283,265,69,22,187,140,1878
39,Malik Beasley,SG,24,MIN,37,36,1214,264,600,0.44,128,321,0.399,136,279,0.487,0.547,68,80,0.85,28,134,162,88,30,7,60,62,724
40,Jordan Bell,C,26,TOT,6,1,82,7,22,0.318,0,2,0,7,20,0.35,0.318,1,2,0.5,7,17,24,7,3,5,4,7,15
40,Jordan Bell,C,26,WAS,5,1,67,7,20,0.35,0,2,0,7,18,0.389,0.35,0,0,,6,13,19,5,3,3,3,5,14
40,Jordan Bell,C,26,GSW,1,0,15,0,2,0,0,0,,0,2,0,0,1,2,0.5,1,4,5,2,0,2,1,2,1
41,DeAndre' Bembry,SF,26,TOR,51,12,972,117,228,0.513,14,53,0.264,103,175,0.589,0.544,45,66,0.682,33,113,146,107,53,18,71,87,293
42,Dāvis Bertāns,PF,28,WAS,57,7,1464,193,478,0.404,169,428,0.395,24,50,0.48,0.581,100,115,0.87,18,150,168,49,33,13,33,136,655
43,Patrick Beverley,PG,32,LAC,37,34,832,93,220,0.423,56,141,0.397,37,79,0.468,0.55,36,45,0.8,29,90,119,76,29,28,34,108,278
44,Saddiq Bey,SF,21,DET,70,53,1909,279,691,0.404,175,460,0.38,104,231,0.45,0.53,124,147,0.844,43,275,318,95,52,14,60,110,857
45,Tyler Bey,SF,22,DAL,18,0,71,7,22,0.318,1,4,0.25,6,18,0.333,0.341,3,5,0.6,8,11,19,3,0,1,3,6,18
46,Khem Birch,C,28,TOT,67,22,1529,189,380,0.497,13,52,0.25,176,328,0.537,0.514,91,129,0.705,174,213,387,89,48,50,44,113,482
46,Khem Birch,C,28,ORL,48,5,952,94,209,0.45,4,21,0.19,90,188,0.479,0.459,63,85,0.741,117,126,243,53,32,28,23,67,255
46,Khem Birch,C,28,TOR,19,17,577,95,171,0.556,9,31,0.29,86,140,0.614,0.582,28,44,0.636,57,87,144,36,16,22,21,46,227
47,Goga Bitadze,C,21,IND,45,3,561,83,194,0.428,20,79,0.253,63,115,0.548,0.479,45,61,0.738,60,90,150,37,9,60,17,94,231
48,Bismack Biyombo,C,28,CHO,66,36,1349,142,242,0.587,0,1,0,142,241,0.589,0.587,47,105,0.448,137,210,347,81,17,74,71,141,331
49,Nemanja Bjelica,PF,32,TOT,37,3,595,89,196,0.454,27,85,0.318,62,111,0.559,0.523,37,51,0.725,29,98,127,69,15,5,33,68,242
49,Nemanja Bjelica,PF,32,SAC,26,1,439,69,150,0.46,17,58,0.293,52,92,0.565,0.517,32,42,0.762,24,76,100,49,8,2,28,48,187
49,Nemanja Bjelica,PF,32,MIA,11,2,156,20,46,0.435,10,27,0.37,10,19,0.526,0.543,5,9,0.556,5,22,27,20,7,3,5,20,55
50,Eric Bledsoe,SG,31,NOP,71,70,2111,307,730,0.421,121,355,0.341,186,375,0.496,0.503,134,195,0.687,29,215,244,268,55,24,114,112,869
51,Keljin Blevins,SF,25,POR,17,0,75,5,20,0.25,2,8,0.25,3,12,0.25,0.3,0,0,,3,7,10,4,2,0,5,8,12
52,Bogdan Bogdanović,SG,28,ATL,44,27,1305,267,565,0.473,146,333,0.438,121,232,0.522,0.602,40,44,0.909,20,140,160,147,49,13,54,99,720
53,Bojan Bogdanović,SF,31,UTA,72,72,2216,406,925,0.439,180,461,0.39,226,464,0.487,0.536,233,265,0.879,40,241,281,136,45,4,128,115,1225
54,Bol Bol,PF,21,DEN,32,2,160,25,58,0.431,9,24,0.375,16,34,0.471,0.509,10,15,0.667,0,24,24,7,3,10,13,14,69
55,Marques Bolden,C,22,CLE,6,0,29,1,3,0.333,0,0,,1,3,0.333,0.333,5,8,0.625,3,3,6,0,2,2,2,0,7
56,Jordan Bone,PG,23,ORL,14,0,196,23,54,0.426,10,32,0.313,13,22,0.591,0.519,0,0,,4,20,24,18,2,0,3,11,56
57,Isaac Bonga,SF,21,WAS,40,8,432,30,81,0.37,13,47,0.277,17,34,0.5,0.451,5,8,0.625,18,48,66,23,11,9,22,63,78
58,Devin Booker,SG,24,PHO,67,67,2270,623,1287,0.484,126,371,0.34,497,916,0.543,0.533,340,392,0.867,34,247,281,289,53,16,207,181,1712
59,Chris Boucher,C,28,TOR,60,14,1453,288,560,0.514,90,235,0.383,198,325,0.609,0.595,152,193,0.788,117,287,404,63,35,111,46,166,818
60,Brian Bowen,SF,22,IND,6,0,15,1,4,0.25,0,1,0,1,3,0.333,0.25,1,1,1,0,3,3,0,0,0,0,1,3
61,Avery Bradley,SG,30,TOT,27,6,602,64,171,0.374,33,101,0.327,31,70,0.443,0.471,12,15,0.8,8,49,57,46,21,3,28,55,173
61,Avery Bradley,SG,30,MIA,10,1,211,31,66,0.47,16,38,0.421,15,28,0.536,0.591,7,9,0.778,2,16,18,14,7,1,9,26,85
61,Avery Bradley,SG,30,HOU,17,5,391,33,105,0.314,17,63,0.27,16,42,0.381,0.395,5,6,0.833,6,33,39,32,14,2,19,29,88
62,Tony Bradley,C,23,TOT,42,8,684,131,197,0.665,0,3,0,131,194,0.675,0.665,38,55,0.691,85,154,239,37,15,30,33,61,300
62,Tony Bradley,C,23,PHI,20,8,287,51,75,0.68,0,1,0,51,74,0.689,0.68,7,11,0.636,39,65,104,17,6,13,6,28,109
62,Tony Bradley,C,23,OKC,22,0,397,80,122,0.656,0,2,0,80,120,0.667,0.656,31,44,0.705,46,89,135,20,9,17,27,33,191
63,Jarrell Brantley,PF,24,UTA,28,0,138,25,52,0.481,12,28,0.429,13,24,0.542,0.596,2,2,1,9,18,27,15,7,2,8,17,64
64,Ignas Brazdeikis,SF,22,TOT,13,0,249,35,83,0.422,11,28,0.393,24,55,0.436,0.488,10,14,0.714,11,34,45,17,4,3,12,22,91
64,Ignas Brazdeikis,SF,22,NYK,4,0,7,0,1,0,0,0,,0,1,0,0,2,2,1,1,1,2,1,0,0,1,0,2
64,Ignas Brazdeikis,SF,22,PHI,1,0,8,0,3,0,0,1,0,0,2,0,0,0,0,,0,2,2,0,0,0,0,0,0
64,Ignas Brazdeikis,SF,22,ORL,8,0,234,35,79,0.443,11,27,0.407,24,52,0.462,0.513,8,12,0.667,10,31,41,16,4,3,11,22,89
65,Mikal Bridges,SF,24,PHO,72,72,2348,363,669,0.543,134,315,0.425,229,354,0.647,0.643,110,131,0.84,76,233,309,152,76,63,57,116,970
66,Miles Bridges,PF,22,CHO,66,19,1932,313,622,0.503,116,290,0.4,197,332,0.593,0.596,98,113,0.867,81,316,397,147,44,52,106,143,840
67,Amida Brimah,C,26,IND,5,0,29,5,8,0.625,0,0,,5,8,0.625,0.625,3,3,1,2,6,8,1,0,5,4,4,13
68,Oshae Brissett,SF,22,IND,21,16,519,73,151,0.483,33,78,0.423,40,73,0.548,0.593,50,65,0.769,29,86,115,18,19,20,10,32,229
69,Malcolm Brogdon,PG,28,IND,56,56,1930,444,980,0.453,145,374,0.388,299,606,0.493,0.527,153,177,0.864,58,236,294,329,49,15,115,110,1186
70,Armoni Brooks,SG,22,HOU,20,5,520,78,192,0.406,60,157,0.382,18,35,0.514,0.563,7,12,0.583,10,58,68,30,12,5,22,34,223
71,Dillon Brooks,SF,25,MEM,67,67,1997,432,1031,0.419,128,372,0.344,304,659,0.461,0.481,159,195,0.815,53,143,196,157,78,26,119,237,1151
72,Bruce Brown,PG,24,BRK,65,37,1451,235,423,0.556,17,59,0.288,218,364,0.599,0.576,86,117,0.735,111,238,349,104,58,28,54,145,573
73,Charlie Brown Jr.,SG,23,OKC,9,1,152,13,43,0.302,5,21,0.238,8,22,0.364,0.36,9,10,0.9,3,14,17,9,4,2,6,19,40
74,Jaylen Brown,SG,24,BOS,58,58,1999,538,1111,0.484,163,411,0.397,375,700,0.536,0.558,191,250,0.764,71,276,347,195,72,32,158,168,1430
75,Moses Brown,C,21,OKC,43,32,920,146,268,0.545,0,0,,146,268,0.545,0.545,78,126,0.619,154,229,383,10,31,47,43,93,370
76,Sterling Brown,SG,25,HOU,51,14,1229,150,335,0.448,91,215,0.423,59,120,0.492,0.584,25,31,0.806,38,186,224,72,38,12,41,97,416
77,Troy Brown Jr.,SF,21,TOT,34,0,524,62,144,0.431,22,70,0.314,40,74,0.541,0.507,15,21,0.714,20,85,105,29,10,6,21,49,161
77,Troy Brown Jr.,SF,21,WAS,21,0,287,33,89,0.371,14,46,0.304,19,43,0.442,0.449,10,15,0.667,11,50,61,19,3,4,16,29,90
77,Troy Brown Jr.,SF,21,CHI,13,0,237,29,55,0.527,8,24,0.333,21,31,0.677,0.6,5,6,0.833,9,35,44,10,7,2,5,20,71
78,Jalen Brunson,PG,24,DAL,68,12,1697,328,627,0.523,81,200,0.405,247,427,0.578,0.588,120,151,0.795,27,204,231,239,35,1,80,109,857
79,Elijah Bryant,SG,25,MIL,1,0,32,6,13,0.462,1,5,0.2,5,8,0.625,0.5,3,3,1,2,4,6,3,0,1,4,4,16
80,Thomas Bryant,C,23,WAS,10,10,271,59,91,0.648,9,21,0.429,50,70,0.714,0.698,16,24,0.667,18,43,61,15,4,8,11,31,143
81,Reggie Bullock,SF,29,NYK,65,64,1949,248,561,0.442,163,398,0.41,85,163,0.521,0.587,50,55,0.909,16,207,223,99,52,11,45,146,709
82,Trey Burke,PG,28,DAL,62,1,911,151,353,0.428,58,164,0.354,93,189,0.492,0.51,51,57,0.895,10,44,54,81,36,7,33,64,411
83,Alec Burks,SG,29,NYK,49,5,1255,210,500,0.42,102,246,0.415,108,254,0.425,0.522,101,118,0.856,21,206,227,107,31,14,49,102,623
84,Jimmy Butler,SF,31,MIA,52,52,1745,366,736,0.497,25,102,0.245,341,634,0.538,0.514,359,416,0.863,94,265,359,369,108,18,109,71,1116
85,Bruno Caboclo,PF,25,HOU,6,0,36,8,17,0.471,0,5,0,8,12,0.667,0.471,1,2,0.5,3,11,14,1,0,2,4,6,17
86,Devontae Cacok,PF,24,LAL,20,1,98,17,29,0.586,0,0,,17,29,0.586,0.586,5,11,0.455,12,20,32,1,5,4,5,8,39
87,Kentavious Caldwell-Pope,SG,27,LAL,67,67,1902,218,506,0.431,120,293,0.41,98,213,0.46,0.549,97,112,0.866,27,152,179,127,62,26,66,114,653
88,Facundo Campazzo,PG,29,DEN,65,19,1425,120,315,0.381,76,216,0.352,44,99,0.444,0.502,80,91,0.879,22,112,134,232,79,14,73,132,396
89,Vlatko Čančar,PF,23,DEN,41,1,281,33,72,0.458,9,33,0.273,24,39,0.615,0.521,10,13,0.769,11,39,50,14,11,2,14,18,85
90,Devin Cannady,PG,24,ORL,8,0,74,11,28,0.393,6,16,0.375,5,12,0.417,0.5,6,7,0.857,0,5,5,1,5,1,2,9,34
91,Clint Capela,C,26,ATL,63,63,1898,413,695,0.594,0,0,,413,695,0.594,0.594,130,227,0.573,297,606,903,49,44,129,73,145,956
92,Vernon Carey Jr.,C,19,CHO,19,4,115,18,36,0.5,1,7,0.143,17,29,0.586,0.514,9,11,0.818,6,21,27,2,1,5,5,13,46
93,Jevon Carter,PG,25,PHO,60,1,717,94,223,0.422,56,151,0.371,38,72,0.528,0.547,4,7,0.571,16,76,92,71,29,9,16,56,248
94,Wendell Carter Jr.,C,21,TOT,54,44,1375,230,457,0.503,15,51,0.294,215,406,0.53,0.52,131,179,0.732,132,311,443,104,35,42,78,146,606
94,Wendell Carter Jr.,C,21,CHI,32,25,792,129,252,0.512,8,22,0.364,121,230,0.526,0.528,82,111,0.739,70,180,250,69,18,24,49,96,348
94,Wendell Carter Jr.,C,21,ORL,22,19,583,101,205,0.493,7,29,0.241,94,176,0.534,0.51,49,68,0.721,62,131,193,35,17,18,29,50,258
95,Michael Carter-Williams,SG,29,ORL,31,25,800,105,270,0.389,15,61,0.246,90,209,0.431,0.417,49,80,0.613,39,100,139,129,25,17,69,81,274
96,Alex Caruso,PG,26,LAL,58,6,1216,133,305,0.436,55,137,0.401,78,168,0.464,0.526,49,76,0.645,31,139,170,160,64,15,76,108,370
97,Willie Cauley-Stein,C,27,DAL,53,16,906,115,182,0.632,1,11,0.091,114,171,0.667,0.635,49,78,0.628,66,170,236,35,21,43,29,129,280
98,Chris Chiozza,PG,25,BRK,22,1,232,31,88,0.352,13,42,0.31,18,46,0.391,0.426,13,17,0.765,3,21,24,65,7,6,16,19,88
99,Marquese Chriss,PF,23,GSW,2,0,27,5,14,0.357,1,5,0.2,4,9,0.444,0.393,2,4,0.5,3,10,13,2,0,2,2,3,13
100,Gary Clark,SF-PF,26,TOT,39,11,654,40,132,0.303,31,108,0.287,9,24,0.375,0.42,8,10,0.8,33,82,115,31,13,7,17,35,119
100,Gary Clark,SF,26,ORL,35,11,637,40,131,0.305,31,108,0.287,9,23,0.391,0.424,8,10,0.8,33,79,112,30,12,7,17,34,119
100,Gary Clark,SF,26,DEN,2,0,4,0,0,,0,0,,0,0,,,0,0,,0,1,1,0,0,0,0,0,0
100,Gary Clark,PF,26,PHI,2,0,13,0,1,0,0,0,,0,1,0,0,0,0,,0,2,2,1,1,0,0,1,0
101,Brandon Clarke,PF,24,MEM,59,16,1415,256,495,0.517,20,77,0.26,236,418,0.565,0.537,78,113,0.69,97,231,328,95,60,51,33,84,610
102,Jordan Clarkson,SG,28,UTA,68,1,1818,457,1075,0.425,208,599,0.347,249,476,0.523,0.522,129,144,0.896,47,227,274,168,61,10,115,110,1251
103,Nic Claxton,C,21,BRK,32,1,594,90,145,0.621,1,5,0.2,89,140,0.636,0.624,31,64,0.484,43,123,166,28,23,40,18,68,212
104,Amir Coffey,SG,23,LAC,44,1,394,45,103,0.437,23,56,0.411,22,47,0.468,0.549,27,38,0.711,10,34,44,22,10,0,15,30,140
105,John Collins,PF,23,ATL,63,63,1848,429,771,0.556,83,208,0.399,346,563,0.615,0.61,170,204,0.833,118,349,467,78,34,63,84,193,1111
106,Mike Conley,PG,33,UTA,51,51,1498,284,640,0.444,138,335,0.412,146,305,0.479,0.552,121,142,0.852,36,141,177,305,70,9,99,98,827
107,Pat Connaughton,SG,28,MIL,69,4,1575,168,387,0.434,101,272,0.371,67,115,0.583,0.565,31,40,0.775,63,269,332,81,49,23,33,99,468
108,Quinn Cook,PG,27,TOT,23,0,157,29,68,0.426,11,26,0.423,18,42,0.429,0.507,7,8,0.875,2,15,17,18,4,1,7,10,76
108,Quinn Cook,PG,27,LAL,16,0,62,12,26,0.462,5,13,0.385,7,13,0.538,0.558,4,5,0.8,0,5,5,5,1,1,3,2,33
108,Quinn Cook,PG,27,CLE,7,0,95,17,42,0.405,6,13,0.462,11,29,0.379,0.476,3,3,1,2,10,12,13,3,0,4,8,43
109,Tyler Cook,SF-PF,23,TOT,32,1,438,69,103,0.67,1,2,0.5,68,101,0.673,0.675,17,35,0.486,28,67,95,17,8,2,21,35,156
109,Tyler Cook,PF,23,BRK,4,0,17,1,3,0.333,0,0,,1,3,0.333,0.333,0,0,,1,1,2,2,0,0,1,2,2
109,Tyler Cook,SF,23,DET,28,1,421,68,100,0.68,1,2,0.5,67,98,0.684,0.685,17,35,0.486,27,66,93,15,8,2,20,33,154
110,DeMarcus Cousins,C,30,TOT,41,11,713,130,305,0.426,47,135,0.348,83,170,0.488,0.503,59,81,0.728,53,210,263,76,34,24,64,107,366
110,DeMarcus Cousins,C,30,HOU,25,11,506,79,210,0.376,39,116,0.336,40,94,0.426,0.469,44,59,0.746,30,161,191,60,21,18,39,74,241
110,DeMarcus Cousins,C,30,LAC,16,0,207,51,95,0.537,8,19,0.421,43,76,0.566,0.579,15,22,0.682,23,49,72,16,13,6,25,33,125
111,Robert Covington,PF,30,POR,70,70,2243,204,509,0.401,135,356,0.379,69,153,0.451,0.533,50,62,0.806,61,405,466,117,101,84,64,195,593
112,Torrey Craig,SF,30,TOT,50,8,803,109,227,0.48,39,106,0.368,70,121,0.579,0.566,17,22,0.773,57,140,197,49,28,26,25,83,274
112,Torrey Craig,SF,30,MIL,18,0,201,18,46,0.391,8,22,0.364,10,24,0.417,0.478,1,2,0.5,13,30,43,16,9,7,5,24,45
112,Torrey Craig,SF,30,PHO,32,8,602,91,181,0.503,31,84,0.369,60,97,0.619,0.588,16,20,0.8,44,110,154,33,19,19,20,59,229
113,Jae Crowder,PF,30,PHO,60,42,1648,199,492,0.404,148,380,0.389,51,112,0.455,0.555,57,75,0.76,32,250,282,127,48,27,55,125,603
114,Jarrett Culver,SG,21,MIN,34,7,499,69,168,0.411,13,53,0.245,56,115,0.487,0.449,29,48,0.604,34,70,104,24,17,9,28,58,180
115,Seth Curry,SG,30,PHI,57,57,1638,258,552,0.467,126,280,0.45,132,272,0.485,0.582,69,77,0.896,10,126,136,155,44,8,65,96,711
116,Stephen Curry,PG,32,GSW,63,63,2152,658,1365,0.482,337,801,0.421,321,564,0.569,0.605,362,395,0.916,29,316,345,363,77,8,213,119,2015
117,Nate Darling,SG,22,CHO,7,0,26,2,7,0.286,2,7,0.286,0,0,,0.429,3,3,1,1,0,1,1,0,1,1,1,9
118,Anthony Davis,PF,27,LAL,36,36,1162,301,613,0.491,26,100,0.26,275,513,0.536,0.512,158,214,0.738,62,224,286,110,45,59,74,60,786
119,Ed Davis,C,31,MIN,23,7,299,19,44,0.432,0,0,,19,44,0.432,0.432,10,12,0.833,46,69,115,21,13,13,7,56,48
120,Terence Davis,SG,23,TOT,61,4,1074,195,456,0.428,98,267,0.367,97,189,0.513,0.535,45,55,0.818,20,134,154,83,44,14,63,97,533
120,Terence Davis,SG,23,TOR,34,4,493,87,210,0.414,44,122,0.361,43,88,0.489,0.519,16,18,0.889,9,57,66,37,17,7,29,48,234
120,Terence Davis,SG,23,SAC,27,0,581,108,246,0.439,54,145,0.372,54,101,0.535,0.549,29,37,0.784,11,77,88,46,27,7,34,49,299
121,Gabriel Deck,PF,25,OKC,10,0,212,32,67,0.478,2,15,0.133,30,52,0.577,0.493,18,22,0.818,16,24,40,24,8,0,6,9,84
122,Dewayne Dedmon,C,31,MIA,16,0,210,46,65,0.708,1,5,0.2,45,60,0.75,0.715,20,27,0.741,28,58,86,12,9,6,13,36,113
123,Matthew Dellavedova,PG,30,CLE,13,1,224,14,56,0.25,4,25,0.16,10,31,0.323,0.286,4,4,1,6,18,24,58,4,1,6,21,36
124,DeMar DeRozan,PF,31,SAS,61,61,2056,455,920,0.495,19,74,0.257,436,846,0.515,0.505,387,440,0.88,40,219,259,422,56,15,119,128,1316
125,Mamadi Diakite,PF,24,MIL,14,1,141,16,40,0.4,1,8,0.125,15,32,0.469,0.413,11,14,0.786,8,26,34,8,7,6,3,16,44
126,Hamidou Diallo,SG-SF,22,TOT,52,9,1226,224,470,0.477,28,82,0.341,196,388,0.505,0.506,128,200,0.64,59,213,272,101,41,24,76,134,604
126,Hamidou Diallo,SG,22,OKC,32,5,761,143,297,0.481,12,41,0.293,131,256,0.512,0.502,83,132,0.629,37,128,165,77,31,12,49,83,381
126,Hamidou Diallo,SF,22,DET,20,4,465,81,173,0.468,16,41,0.39,65,132,0.492,0.514,45,68,0.662,22,85,107,24,10,12,27,51,223
127,Gorgui Dieng,C,31,TOT,38,1,552,85,163,0.521,30,70,0.429,55,93,0.591,0.613,58,67,0.866,40,100,140,48,26,16,32,56,258
127,Gorgui Dieng,C,31,MEM,22,1,371,56,108,0.519,23,48,0.479,33,60,0.55,0.625,38,43,0.884,28,70,98,29,17,14,22,38,173
127,Gorgui Dieng,C,31,SAS,16,0,181,29,55,0.527,7,22,0.318,22,33,0.667,0.591,20,24,0.833,12,30,42,19,9,2,10,18,85
128,Spencer Dinwiddie,SG,27,BRK,3,3,64,6,16,0.375,2,7,0.286,4,9,0.444,0.438,6,6,1,0,13,13,9,2,1,5,4,20
129,Donte DiVincenzo,SG,24,MIL,66,66,1814,253,603,0.42,131,346,0.379,122,257,0.475,0.528,51,71,0.718,81,299,380,203,72,15,91,112,688
130,Luka Dončić,PG,21,DAL,66,66,2262,647,1351,0.479,192,548,0.35,455,803,0.567,0.55,344,471,0.73,54,473,527,567,64,36,281,152,1830
131,Luguentz Dort,SG,21,OKC,52,52,1543,247,639,0.387,113,329,0.343,134,310,0.432,0.475,122,164,0.744,38,151,189,88,45,19,79,134,729
132,Damyean Dotson,SG,26,CLE,46,7,907,119,293,0.406,46,159,0.289,73,134,0.545,0.485,24,36,0.667,5,88,93,91,16,4,42,42,308
133,Devon Dotson,PG,21,CHI,11,0,50,11,21,0.524,1,7,0.143,10,14,0.714,0.548,0,0,,2,3,5,7,4,0,0,3,23
134,Sekou Doumbouya,PF,20,DET,56,11,869,107,282,0.379,26,115,0.226,81,167,0.485,0.426,45,64,0.703,39,104,143,47,24,9,44,94,285
135,PJ Dozier,SG,24,DEN,50,6,1088,148,355,0.417,47,149,0.315,101,206,0.49,0.483,42,66,0.636,35,147,182,92,31,22,46,86,385
136,Goran Dragić,PG,34,MIA,50,11,1337,240,555,0.432,91,244,0.373,149,311,0.479,0.514,101,122,0.828,25,144,169,219,33,8,118,113,672
137,Andre Drummond,C,27,TOT,46,46,1242,282,572,0.493,0,8,0,282,564,0.5,0.493,123,205,0.6,166,385,551,94,63,49,124,149,687
137,Andre Drummond,C,27,CLE,25,25,722,180,380,0.474,0,8,0,180,372,0.484,0.474,77,129,0.597,101,236,337,64,40,29,81,69,437
137,Andre Drummond,C,27,LAL,21,21,520,102,192,0.531,0,0,,102,192,0.531,0.531,46,76,0.605,65,149,214,30,23,20,43,80,250
138,Jared Dudley,PF,35,LAL,12,0,81,2,9,0.222,2,6,0.333,0,3,0,0.333,0,0,,4,17,21,5,1,1,2,7,6
139,Kris Dunn,PG,26,ATL,4,0,45,1,12,0.083,0,2,0,1,10,0.1,0.083,3,4,0.75,0,6,6,2,2,2,3,10,5
140,Kevin Durant,PF,32,BRK,35,32,1157,324,603,0.537,85,189,0.45,239,414,0.577,0.608,210,238,0.882,13,234,247,195,25,45,120,70,943
141,Anthony Edwards,SG,19,MIN,72,55,2314,505,1211,0.417,171,520,0.329,334,691,0.483,0.488,211,272,0.776,59,277,336,211,82,36,160,129,1392
142,Carsen Edwards,SG,22,BOS,31,1,276,47,111,0.423,18,63,0.286,29,48,0.604,0.505,11,13,0.846,3,23,26,14,7,1,7,25,123
143,CJ Elleby,SF,20,POR,30,0,192,25,66,0.379,7,34,0.206,18,32,0.563,0.432,11,15,0.733,11,21,32,10,6,3,5,27,68
144,Henry Ellenson,PF,24,TOR,2,0,38,5,14,0.357,2,9,0.222,3,5,0.6,0.429,3,4,0.75,3,9,12,5,0,0,0,7,15
145,Wayne Ellington,SG,33,DET,46,31,1012,149,338,0.441,116,275,0.422,33,63,0.524,0.612,28,35,0.8,12,73,85,67,18,9,33,59,442
146,Joel Embiid,C,26,PHI,51,51,1585,461,899,0.513,58,154,0.377,403,745,0.541,0.545,471,548,0.859,113,426,539,145,50,69,159,123,1451
147,James Ennis III,SF,30,ORL,41,37,986,115,243,0.473,45,104,0.433,70,139,0.504,0.566,70,87,0.805,43,123,166,62,32,7,36,84,345
148,Drew Eubanks,C,23,SAS,54,3,755,116,205,0.566,2,2,1,114,203,0.562,0.571,77,106,0.726,74,167,241,42,18,49,45,88,311
149,Dante Exum,SG,25,CLE,6,3,116,10,26,0.385,2,11,0.182,8,15,0.533,0.423,1,2,0.5,2,15,17,13,4,2,7,9,23
150,Tacko Fall,C,25,BOS,19,0,136,21,29,0.724,0,0,,21,29,0.724,0.724,5,15,0.333,16,36,52,3,1,20,6,22,47
151,Derrick Favors,C,29,UTA,68,0,1039,155,243,0.638,0,2,0,155,241,0.643,0.638,59,80,0.738,138,238,376,44,32,68,36,143,369
152,Cristiano Felício,C,28,CHI,18,0,84,7,13,0.538,0,2,0,7,11,0.636,0.538,9,16,0.563,10,16,26,9,4,0,4,10,23
153,Terrance Ferguson,SG,22,PHI,13,0,49,1,7,0.143,0,5,0,1,2,0.5,0.143,0,0,,0,1,1,2,1,0,4,7,2
154,Bruno Fernando,C,22,ATL,33,0,226,18,44,0.409,0,2,0,18,42,0.429,0.409,15,22,0.682,16,62,78,10,4,3,21,23,51
155,Yogi Ferrell,PG,27,TOT,10,0,136,20,57,0.351,9,28,0.321,11,29,0.379,0.43,7,9,0.778,5,14,19,22,7,3,3,11,56
155,Yogi Ferrell,PG,27,CLE,2,0,40,8,21,0.381,3,9,0.333,5,12,0.417,0.452,0,2,0,3,4,7,5,3,1,3,4,19
155,Yogi Ferrell,PG,27,LAC,8,0,96,12,36,0.333,6,19,0.316,6,17,0.353,0.417,7,7,1,2,10,12,17,4,2,0,7,37
156,Dorian Finney-Smith,PF,27,DAL,60,60,1921,220,466,0.472,119,302,0.394,101,164,0.616,0.6,31,41,0.756,98,228,326,102,52,25,48,138,590
157,Malik Fitts,PF,23,LAC,3,0,11,1,3,0.333,1,2,0.5,0,1,0,0.5,0,0,,0,3,3,0,0,0,0,3,3
158,Malachi Flynn,PG,22,TOR,47,14,928,127,340,0.374,54,168,0.321,73,172,0.424,0.453,45,56,0.804,10,106,116,137,38,7,43,68,353
159,Bryn Forbes,SG,27,MIL,70,10,1354,250,529,0.473,154,341,0.452,96,188,0.511,0.618,47,61,0.77,11,101,112,45,24,1,44,77,701
160,Trent Forrest,PG,22,UTA,30,0,302,32,71,0.451,5,26,0.192,27,45,0.6,0.486,19,19,1,11,33,44,45,9,4,21,22,88
161,Evan Fournier,SF,28,TOT,42,36,1259,247,541,0.457,117,283,0.413,130,258,0.504,0.565,108,137,0.788,10,118,128,144,47,19,73,96,719
161,Evan Fournier,SF,28,ORL,26,26,787,170,369,0.461,73,188,0.388,97,181,0.536,0.56,98,123,0.797,5,70,75,95,27,9,54,55,511
161,Evan Fournier,SF,28,BOS,16,10,472,77,172,0.448,44,95,0.463,33,77,0.429,0.576,10,14,0.714,5,48,53,49,20,10,19,41,208
162,De'Aaron Fox,PG,23,SAC,58,58,2036,529,1110,0.477,103,320,0.322,426,790,0.539,0.523,300,417,0.719,33,170,203,417,87,27,174,170,1461
163,Robert Franks,PF,24,ORL,7,0,101,13,28,0.464,5,15,0.333,8,13,0.615,0.554,12,13,0.923,6,8,14,5,3,3,2,8,43
164,Tim Frazier,PG,30,MEM,5,0,62,3,20,0.15,0,8,0,3,12,0.25,0.15,2,6,0.333,0,8,8,16,2,1,4,7,8
165,Enes Freedom,C,28,POR,72,35,1758,339,561,0.604,1,4,0.25,338,557,0.607,0.605,127,164,0.774,284,511,795,84,33,48,78,168,806
166,Markelle Fultz,PG,22,ORL,8,8,215,41,104,0.394,4,16,0.25,37,88,0.42,0.413,17,19,0.895,5,20,25,43,8,2,18,18,103
167,Wenyen Gabriel,PF,23,NOP,21,0,241,24,60,0.4,13,32,0.406,11,28,0.393,0.508,11,17,0.647,20,34,54,11,9,8,15,32,72
168,Daniel Gafford,C,22,TOT,54,11,791,154,225,0.684,0,0,,154,225,0.684,0.684,72,108,0.667,94,137,231,29,26,75,41,98,380
168,Daniel Gafford,C,22,CHI,31,11,383,60,87,0.69,0,0,,60,87,0.69,0.69,27,41,0.659,44,59,103,17,11,34,22,54,147
168,Daniel Gafford,C,22,WAS,23,0,408,94,138,0.681,0,0,,94,138,0.681,0.681,45,67,0.672,50,78,128,12,15,41,19,44,233
169,Danilo Gallinari,PF,32,ATL,51,4,1222,206,475,0.434,103,254,0.406,103,221,0.466,0.542,161,174,0.925,17,194,211,76,30,10,43,105,676
170,Langston Galloway,SG,29,PHO,40,0,438,66,147,0.449,36,85,0.424,30,62,0.484,0.571,22,23,0.957,7,35,42,26,8,0,13,25,190
171,Darius Garland,PG,21,CLE,54,50,1790,362,802,0.451,105,266,0.395,257,536,0.479,0.517,112,132,0.848,23,106,129,329,66,6,164,110,941
172,Marc Gasol,C,36,LAL,52,42,993,88,194,0.454,50,122,0.41,38,72,0.528,0.582,36,50,0.72,38,177,215,109,26,58,53,115,262
173,Rudy Gay,PF,34,SAS,63,1,1358,264,628,0.42,106,278,0.381,158,350,0.451,0.505,82,102,0.804,42,261,303,88,45,40,65,115,716
174,Paul George,SF,30,LAC,54,54,1821,445,953,0.467,171,416,0.411,274,537,0.51,0.557,198,228,0.868,45,314,359,280,62,24,179,132,1259
175,Taj Gibson,C,35,NYK,45,3,936,99,158,0.627,3,15,0.2,96,143,0.671,0.636,40,55,0.727,99,151,250,36,31,49,22,99,241
176,Harry Giles,C,22,POR,38,0,348,42,97,0.433,8,23,0.348,34,74,0.459,0.474,16,27,0.593,31,102,133,29,8,13,20,54,108
177,Shai Gilgeous-Alexander,SG,22,OKC,35,35,1180,287,565,0.508,71,170,0.418,216,395,0.547,0.571,185,229,0.808,19,147,166,207,27,23,106,70,830
178,Anthony Gill,PF,28,WAS,26,4,218,30,60,0.5,7,24,0.292,23,36,0.639,0.558,13,16,0.813,16,35,51,11,10,4,8,27,80
179,Freddie Gillespie,PF,23,TOR,20,2,392,44,84,0.524,0,0,,44,84,0.524,0.524,23,33,0.697,42,55,97,9,13,20,12,43,111
180,Rudy Gobert,C,28,UTA,71,71,2187,391,579,0.675,0,4,0,391,575,0.68,0.675,233,374,0.623,240,720,960,89,40,190,118,163,1015
181,Brandon Goodwin,PG,25,ATL,47,5,620,84,223,0.377,32,103,0.311,52,120,0.433,0.448,28,43,0.651,8,61,69,95,17,0,36,41,228
182,Aaron Gordon,PF,25,TOT,50,50,1384,231,499,0.463,59,176,0.335,172,323,0.533,0.522,97,149,0.651,77,207,284,161,33,34,97,89,618
182,Aaron Gordon,PF,25,ORL,25,25,736,128,293,0.437,42,112,0.375,86,181,0.475,0.509,66,105,0.629,39,127,166,105,16,20,67,49,364
182,Aaron Gordon,PF,25,DEN,25,25,648,103,206,0.5,17,64,0.266,86,142,0.606,0.541,31,44,0.705,38,80,118,56,17,14,30,40,254
183,Eric Gordon,SG,32,HOU,27,13,789,159,367,0.433,69,210,0.329,90,157,0.573,0.527,94,114,0.825,8,50,58,71,14,13,51,44,481
184,Devonte' Graham,PG,25,CHO,55,44,1659,252,669,0.377,179,477,0.375,73,192,0.38,0.51,133,158,0.842,22,126,148,295,48,6,84,77,816
185,Jerami Grant,SF,26,DET,54,54,1829,400,932,0.429,115,329,0.35,285,603,0.473,0.491,290,343,0.845,35,215,250,152,35,58,109,125,1205
186,Danny Green,SF,33,PHI,69,69,1934,224,544,0.412,175,432,0.405,49,112,0.438,0.573,31,40,0.775,55,205,260,118,92,56,67,125,654
187,Draymond Green,PF,30,GSW,63,63,1982,170,380,0.447,34,126,0.27,136,254,0.535,0.492,70,88,0.795,55,394,449,558,105,52,188,194,444
188,JaMychal Green,PF,30,DEN,58,5,1120,173,374,0.463,79,198,0.399,94,176,0.534,0.568,46,57,0.807,85,192,277,53,26,22,53,144,471
189,Javonte Green,SF-SG,27,TOT,41,2,473,53,102,0.52,10,30,0.333,43,72,0.597,0.569,30,40,0.75,26,45,71,17,28,6,19,45,146
189,Javonte Green,SF,27,BOS,25,2,345,39,71,0.549,7,22,0.318,32,49,0.653,0.599,20,30,0.667,20,32,52,11,18,2,13,32,105
189,Javonte Green,SG,27,CHI,16,0,128,14,31,0.452,3,8,0.375,11,23,0.478,0.5,10,10,1,6,13,19,6,10,4,6,13,41
190,Jeff Green,PF,34,BRK,68,38,1835,261,530,0.492,103,250,0.412,158,280,0.564,0.59,125,161,0.776,34,229,263,108,36,27,54,122,750
191,Josh Green,SG,20,DAL,39,5,445,42,93,0.452,4,25,0.16,38,68,0.559,0.473,13,23,0.565,28,50,78,28,16,3,17,35,101
192,Blake Griffin,PF,31,TOT,46,30,1186,174,411,0.423,70,205,0.341,104,206,0.505,0.509,87,117,0.744,35,190,225,140,32,15,62,111,505
192,Blake Griffin,PF,31,DET,20,20,626,81,222,0.365,39,124,0.315,42,98,0.429,0.453,44,62,0.71,7,97,104,77,14,2,32,42,245
192,Blake Griffin,PF,31,BRK,26,10,560,93,189,0.492,31,81,0.383,62,108,0.574,0.574,43,55,0.782,28,93,121,63,18,13,30,69,260
193,Kyle Guy,PG,23,SAC,31,0,235,29,88,0.33,13,46,0.283,16,42,0.381,0.403,16,20,0.8,5,30,35,32,6,0,11,20,87
194,Rui Hachimura,PF,22,WAS,57,57,1797,310,648,0.478,45,137,0.328,265,511,0.519,0.513,124,161,0.77,49,263,312,82,44,7,68,120,789
195,Ashton Hagans,PG,21,MIN,2,0,4,0,0,,0,0,,0,0,,,0,0,,0,0,0,0,0,0,1,0,0
196,Tyrese Haliburton,PG,20,SAC,58,20,1746,292,619,0.472,121,296,0.409,171,323,0.529,0.569,48,56,0.857,39,134,173,309,77,28,92,83,753
197,Donta Hall,PF,23,ORL,13,0,179,25,35,0.714,0,0,,25,35,0.714,0.714,23,34,0.676,24,38,62,11,5,10,8,18,73
198,Josh Hall,SF,20,OKC,21,1,336,30,99,0.303,4,37,0.108,26,62,0.419,0.323,22,44,0.5,6,53,59,28,4,1,25,37,86
199,R.J. Hampton,SG,19,TOT,51,1,888,136,313,0.435,27,87,0.31,109,226,0.482,0.478,55,82,0.671,29,150,179,87,21,10,53,61,354
199,R.J. Hampton,SG,19,DEN,25,0,233,25,60,0.417,5,18,0.278,20,42,0.476,0.458,9,12,0.75,10,40,50,14,5,2,11,22,64
199,R.J. Hampton,SG,19,ORL,26,1,655,111,253,0.439,22,69,0.319,89,184,0.484,0.482,46,70,0.657,19,110,129,73,16,8,42,39,290
200,Tim Hardaway Jr.,SG,28,DAL,70,31,1985,407,911,0.447,207,529,0.391,200,382,0.524,0.56,142,174,0.816,20,209,229,126,31,11,64,111,1163
201,James Harden,PG,31,TOT,44,43,1609,342,734,0.466,121,334,0.362,221,400,0.553,0.548,278,323,0.861,35,313,348,475,53,33,177,99,1083
201,James Harden,PG,31,HOU,8,8,290,60,135,0.444,25,72,0.347,35,63,0.556,0.537,53,60,0.883,5,36,41,83,7,6,34,14,198
201,James Harden,PG,31,BRK,36,35,1319,282,599,0.471,96,262,0.366,186,337,0.552,0.551,225,263,0.856,30,277,307,392,46,27,143,85,885
202,Maurice Harkless,PF-SF,27,TOT,37,23,772,69,165,0.418,23,84,0.274,46,81,0.568,0.488,33,43,0.767,13,76,89,44,30,20,22,86,194
202,Maurice Harkless,SF,27,MIA,11,3,124,5,13,0.385,5,11,0.455,0,2,0,0.577,0,2,0,2,11,13,7,2,4,3,14,15
202,Maurice Harkless,PF,27,SAC,26,20,648,64,152,0.421,18,73,0.247,46,79,0.582,0.48,33,41,0.805,11,65,76,37,28,16,19,72,179
203,Jared Harper,PG,23,NYK,8,0,16,0,4,0,0,1,0,0,3,0,0,3,4,0.75,0,2,2,1,0,0,3,1,3
204,Montrezl Harrell,C,27,LAL,69,1,1580,375,603,0.622,0,10,0,375,593,0.632,0.622,181,256,0.707,158,270,428,73,46,49,74,128,931
205,Gary Harris,SG,26,TOT,39,38,1080,138,345,0.4,48,141,0.34,90,204,0.441,0.47,64,78,0.821,21,58,79,78,28,11,37,71,388
205,Gary Harris,SG,26,DEN,19,19,581,69,156,0.442,24,75,0.32,45,81,0.556,0.519,22,30,0.733,13,34,47,32,17,4,14,37,184
205,Gary Harris,SG,26,ORL,20,19,499,69,189,0.365,24,66,0.364,45,123,0.366,0.429,42,48,0.875,8,24,32,46,11,7,23,34,204
206,Jalen Harris,SG,22,TOR,13,2,172,36,72,0.5,17,36,0.472,19,36,0.528,0.618,7,9,0.778,3,15,18,17,8,0,14,15,96
207,Joe Harris,SF,29,BRK,69,65,2141,357,707,0.505,211,444,0.475,146,263,0.555,0.654,49,63,0.778,43,205,248,130,46,14,62,141,974
208,Tobias Harris,PF,28,PHI,62,62,2014,473,924,0.512,82,208,0.394,391,716,0.546,0.556,182,204,0.892,62,357,419,220,55,51,107,119,1210
209,Shaquille Harrison,SG,27,TOT,34,0,333,26,78,0.333,3,16,0.188,23,62,0.371,0.353,18,22,0.818,7,41,48,25,17,5,11,33,73
209,Shaquille Harrison,SG,27,UTA,17,0,56,6,20,0.3,0,2,0,6,18,0.333,0.3,5,6,0.833,3,6,9,9,2,0,5,3,17
209,Shaquille Harrison,SG,27,DEN,17,0,277,20,58,0.345,3,14,0.214,17,44,0.386,0.371,13,16,0.813,4,35,39,16,15,5,6,30,56
210,Josh Hart,SF,25,NOP,47,4,1349,151,344,0.439,63,193,0.326,88,151,0.583,0.531,69,89,0.775,53,324,377,109,38,12,49,111,434
211,Isaiah Hartenstein,C,22,TOT,46,2,559,94,171,0.55,2,6,0.333,92,165,0.558,0.556,46,71,0.648,65,116,181,55,19,39,44,104,236
211,Isaiah Hartenstein,C,22,DEN,30,0,272,41,80,0.513,0,0,,41,80,0.513,0.513,22,36,0.611,40,45,85,15,11,20,21,59,104
211,Isaiah Hartenstein,C,22,CLE,16,2,287,53,91,0.582,2,6,0.333,51,85,0.6,0.593,24,35,0.686,25,71,96,40,8,19,23,45,132
212,Udonis Haslem,C,40,MIA,1,0,3,2,2,1,0,0,,2,2,1,1,0,0,,0,1,1,0,0,0,0,0,4
213,Jaxson Hayes,C,20,NOP,60,3,964,175,280,0.625,6,14,0.429,169,266,0.635,0.636,93,120,0.775,92,165,257,35,25,38,39,101,449
214,Killian Hayes,PG,19,DET,26,18,670,71,201,0.353,20,72,0.278,51,129,0.395,0.403,14,17,0.824,6,63,69,138,27,10,83,57,176
215,Gordon Hayward,SF,30,CHO,44,44,1496,311,658,0.473,85,205,0.415,226,453,0.499,0.537,156,185,0.843,37,221,258,181,52,14,91,74,863
216,Juancho Hernangómez,PF,25,MIN,52,6,900,130,299,0.435,55,168,0.327,75,131,0.573,0.527,60,97,0.619,45,160,205,35,19,7,27,52,375
217,Willy Hernangómez,C,26,NOP,47,12,846,151,268,0.563,1,10,0.1,150,258,0.581,0.565,62,93,0.667,117,217,334,50,22,23,34,68,365
218,Tyler Herro,SG,21,MIA,54,15,1635,307,699,0.439,107,297,0.36,200,402,0.498,0.516,94,117,0.803,25,243,268,184,35,17,101,71,815
219,Buddy Hield,SG,28,SAC,71,71,2433,403,992,0.406,282,721,0.391,121,271,0.446,0.548,88,104,0.846,29,305,334,257,63,30,130,175,1176
220,George Hill,PG,34,TOT,30,17,672,95,197,0.482,31,80,0.388,64,117,0.547,0.561,40,50,0.8,16,45,61,73,23,5,31,31,261
220,George Hill,PG,34,OKC,14,14,369,61,120,0.508,22,57,0.386,39,63,0.619,0.6,21,25,0.84,8,21,29,43,12,2,12,12,165
220,George Hill,PG,34,PHI,16,3,303,34,77,0.442,9,23,0.391,25,54,0.463,0.5,19,25,0.76,8,24,32,30,11,3,19,19,96
221,Solomon Hill,PF,29,ATL,71,16,1513,107,298,0.359,68,212,0.321,39,86,0.453,0.473,35,46,0.761,42,172,214,75,50,11,42,116,317
222,Nate Hinton,SG,21,DAL,21,0,93,15,42,0.357,4,19,0.211,11,23,0.478,0.405,7,10,0.7,1,8,9,8,7,2,5,8,41
223,Jaylen Hoard,SF,21,OKC,19,0,320,44,88,0.5,0,11,0,44,77,0.571,0.5,28,41,0.683,21,44,65,24,13,5,17,19,116
224,Aaron Holiday,PG,24,IND,66,8,1176,170,436,0.39,67,182,0.368,103,254,0.406,0.467,68,83,0.819,15,74,89,123,46,13,66,94,475
225,Jrue Holiday,PG,30,MIL,59,56,1907,414,823,0.503,111,283,0.392,303,540,0.561,0.57,107,136,0.787,73,195,268,357,96,37,127,98,1046
226,Justin Holiday,SG,31,IND,72,52,2183,258,625,0.413,173,453,0.382,85,172,0.494,0.551,67,85,0.788,32,224,256,119,74,41,54,135,756
227,Rondae Hollis-Jefferson,PF,26,POR,11,1,107,9,18,0.5,0,1,0,9,17,0.529,0.5,9,16,0.563,11,15,26,13,2,4,2,15,27
228,Richaun Holmes,C,27,SAC,61,61,1782,366,575,0.637,2,11,0.182,364,564,0.645,0.638,135,170,0.794,144,360,504,101,39,96,75,213,869
229,Rodney Hood,SF,28,TOT,55,5,942,94,260,0.362,34,113,0.301,60,147,0.408,0.427,24,28,0.857,23,80,103,53,24,7,36,74,246
229,Rodney Hood,SF,28,POR,38,5,726,73,201,0.363,25,84,0.298,48,117,0.41,0.425,9,12,0.75,18,55,73,47,20,4,31,59,180
229,Rodney Hood,SF,28,TOR,17,0,216,21,59,0.356,9,29,0.31,12,30,0.4,0.432,15,16,0.938,5,25,30,6,4,3,5,15,66
230,Al Horford,C,34,OKC,28,28,782,162,360,0.45,56,152,0.368,106,208,0.51,0.528,18,22,0.818,29,159,188,94,25,26,29,48,398
231,Talen Horton-Tucker,SG,20,LAL,65,4,1304,224,489,0.458,37,131,0.282,187,358,0.522,0.496,100,129,0.775,25,144,169,181,63,21,105,127,585
232,Danuel House Jr.,SF,27,HOU,36,23,932,110,272,0.404,54,156,0.346,56,116,0.483,0.504,41,63,0.651,18,114,132,69,20,16,36,67,315
233,Dwight Howard,C,35,PHI,69,6,1196,178,303,0.587,5,20,0.25,173,283,0.611,0.596,121,210,0.576,190,390,580,61,30,62,112,200,482
234,Markus Howard,SG,21,DEN,37,1,205,40,106,0.377,18,65,0.277,22,41,0.537,0.462,7,9,0.778,1,20,21,18,4,1,18,23,105
235,Kevin Huerter,SG,22,ATL,69,49,2126,316,731,0.432,140,386,0.363,176,345,0.51,0.528,50,64,0.781,38,193,231,241,82,18,79,165,822
236,Elijah Hughes,SF,22,UTA,18,0,64,10,30,0.333,8,23,0.348,2,7,0.286,0.467,3,4,0.75,1,8,9,6,1,1,6,1,31
237,De'Andre Hunter,SF,23,ATL,23,19,678,120,248,0.484,31,95,0.326,89,153,0.582,0.546,73,85,0.859,17,93,110,44,19,12,29,59,344
238,Chandler Hutchison,SF,24,TOT,25,1,346,39,103,0.379,8,22,0.364,31,81,0.383,0.417,21,25,0.84,6,72,78,17,12,5,20,33,107
238,Chandler Hutchison,SF,24,CHI,7,0,64,5,18,0.278,1,3,0.333,4,15,0.267,0.306,2,2,1,1,19,20,4,1,0,5,9,13
238,Chandler Hutchison,SF,24,WAS,18,1,282,34,85,0.4,7,19,0.368,27,66,0.409,0.441,19,23,0.826,5,53,58,13,11,5,15,24,94
239,Serge Ibaka,C,31,LAC,41,39,955,186,365,0.51,39,115,0.339,147,250,0.588,0.563,43,53,0.811,73,202,275,74,9,47,44,76,454
240,Andre Iguodala,SF,37,MIA,63,5,1339,95,248,0.383,60,182,0.33,35,66,0.53,0.504,25,38,0.658,38,183,221,142,57,35,67,90,275
241,Ersan İlyasova,PF,33,UTA,17,1,148,21,54,0.389,18,41,0.439,3,13,0.231,0.556,5,5,1,7,22,29,4,10,3,8,29,65
242,Joe Ingles,SF,33,UTA,67,30,1867,275,562,0.489,183,406,0.451,92,156,0.59,0.652,76,90,0.844,27,217,244,318,45,12,117,120,809
243,Brandon Ingram,SF,23,NOP,61,61,2093,513,1101,0.466,143,375,0.381,370,726,0.51,0.531,281,320,0.878,34,265,299,296,42,36,154,124,1450
244,Kyrie Irving,PG,28,BRK,54,54,1886,549,1086,0.506,152,378,0.402,397,708,0.561,0.576,201,218,0.922,52,205,257,324,76,37,130,140,1451
245,Wes Iwundu,SF,26,TOT,41,4,539,34,102,0.333,5,41,0.122,29,61,0.475,0.358,26,31,0.839,15,75,90,18,15,4,19,49,99
245,Wes Iwundu,SF,26,DAL,23,3,288,17,52,0.327,3,23,0.13,14,29,0.483,0.356,12,14,0.857,6,38,44,10,9,3,6,26,49
245,Wes Iwundu,SF,26,NOP,18,1,251,17,50,0.34,2,18,0.111,15,32,0.469,0.36,14,17,0.824,9,37,46,8,6,1,13,23,50
246,Frank Jackson,PG,22,DET,40,6,738,134,293,0.457,61,150,0.407,73,143,0.51,0.561,61,75,0.813,15,71,86,36,15,1,34,53,390
247,Jaren Jackson Jr.,C,21,MEM,11,4,258,53,125,0.424,17,60,0.283,36,65,0.554,0.492,35,42,0.833,17,45,62,12,12,18,15,42,158
248,Josh Jackson,SG,23,DET,62,25,1560,296,707,0.419,77,257,0.3,219,450,0.487,0.473,159,218,0.729,57,197,254,143,53,47,142,178,828
249,Justin Jackson,SF,25,TOT,34,3,577,89,221,0.403,36,117,0.308,53,104,0.51,0.484,31,37,0.838,16,61,77,52,15,2,32,32,245
249,Justin Jackson,SF,25,OKC,33,3,544,86,212,0.406,34,111,0.306,52,101,0.515,0.486,30,35,0.857,14,57,71,51,15,2,31,31,236
249,Justin Jackson,SF,25,MIL,1,0,33,3,9,0.333,2,6,0.333,1,3,0.333,0.444,1,2,0.5,2,4,6,1,0,0,1,1,9
250,Reggie Jackson,SG,30,LAC,67,43,1544,263,585,0.45,122,282,0.433,141,303,0.465,0.554,67,82,0.817,24,168,192,205,41,7,74,127,715
251,Justin James,SF,24,SAC,36,0,310,52,111,0.468,14,38,0.368,38,73,0.521,0.532,21,36,0.583,9,21,30,22,8,3,15,23,139
252,LeBron James,PG,36,LAL,45,45,1504,422,823,0.513,104,285,0.365,318,538,0.591,0.576,178,255,0.698,29,317,346,350,48,25,168,70,1126
253,Mike James,PG,30,BRK,13,1,236,34,92,0.37,11,31,0.355,23,61,0.377,0.429,21,27,0.778,3,29,32,54,6,1,20,10,100
254,DaQuan Jeffries,SG,23,TOT,31,5,493,50,120,0.417,20,67,0.299,30,53,0.566,0.5,7,8,0.875,19,52,71,22,15,10,14,48,127
254,DaQuan Jeffries,SG,23,SAC,18,2,232,24,57,0.421,9,28,0.321,15,29,0.517,0.5,6,7,0.857,9,20,29,6,7,4,8,23,63
254,DaQuan Jeffries,SG,23,HOU,13,3,261,26,63,0.413,11,39,0.282,15,24,0.625,0.5,1,1,1,10,32,42,16,8,6,6,25,64
255,Ty Jerome,SG,23,OKC,33,1,788,128,287,0.446,71,168,0.423,57,119,0.479,0.57,26,34,0.765,10,81,91,120,20,6,47,61,353
256,Isaiah Joe,SG,21,PHI,41,1,383,48,133,0.361,39,106,0.368,9,27,0.333,0.508,18,24,0.75,6,30,36,20,12,4,11,34,153
257,Alize Johnson,PF,24,BRK,18,0,189,40,68,0.588,1,6,0.167,39,62,0.629,0.596,13,13,1,27,63,90,14,5,5,9,16,94
258,Cameron Johnson,PF,24,PHO,60,11,1437,203,483,0.42,117,335,0.349,86,148,0.581,0.541,50,59,0.847,33,166,199,86,37,16,40,85,573
259,James Johnson,PF,33,TOT,51,12,1043,146,327,0.446,31,120,0.258,115,207,0.556,0.494,45,76,0.592,32,145,177,98,42,42,55,120,368
259,James Johnson,PF,33,DAL,29,1,504,67,145,0.462,15,60,0.25,52,85,0.612,0.514,17,29,0.586,14,72,86,50,24,23,27,59,166
259,James Johnson,PF,33,NOP,22,11,539,79,182,0.434,16,60,0.267,63,122,0.516,0.478,28,47,0.596,18,73,91,48,18,19,28,61,202
260,Keldon Johnson,SF,21,SAS,69,67,1968,338,705,0.479,60,181,0.331,278,524,0.531,0.522,145,196,0.74,93,319,412,121,40,24,78,142,881
261,Stanley Johnson,PF,24,TOR,61,13,1006,89,233,0.382,45,137,0.328,44,96,0.458,0.479,44,55,0.8,29,124,153,89,52,18,54,116,267
262,Tyler Johnson,SG,28,BRK,39,3,684,72,183,0.393,48,132,0.364,24,51,0.471,0.525,18,21,0.857,6,71,77,47,14,0,17,43,210
263,Nikola Jokić,C,25,DEN,72,72,2488,732,1293,0.566,92,237,0.388,640,1056,0.606,0.602,342,394,0.868,205,575,780,599,95,48,222,192,1898
264,Damian Jones,C,25,TOT,39,10,547,70,103,0.68,1,5,0.2,69,98,0.704,0.684,42,58,0.724,36,85,121,29,11,29,26,77,183
264,Damian Jones,C,25,PHO,14,0,94,8,16,0.5,0,1,0,8,15,0.533,0.5,6,11,0.545,7,11,18,4,1,5,6,19,22
264,Damian Jones,C,25,LAL,8,6,112,16,17,0.941,0,0,,16,17,0.941,0.941,11,12,0.917,8,18,26,1,1,7,5,22,43
264,Damian Jones,C,25,SAC,17,4,341,46,70,0.657,1,4,0.25,45,66,0.682,0.664,25,35,0.714,21,56,77,24,9,17,15,36,118
265,Derrick Jones Jr.,SF,23,POR,58,43,1318,147,304,0.484,43,136,0.316,104,168,0.619,0.554,59,91,0.648,77,128,205,47,37,54,32,127,396
266,Mason Jones,SG,22,TOT,32,1,334,52,123,0.423,24,66,0.364,28,57,0.491,0.52,40,64,0.625,7,48,55,42,7,1,29,24,168
266,Mason Jones,SG,22,HOU,26,1,307,47,114,0.412,23,64,0.359,24,50,0.48,0.513,35,57,0.614,4,47,51,39,6,1,28,22,152
266,Mason Jones,SG,22,PHI,6,0,27,5,9,0.556,1,2,0.5,4,7,0.571,0.611,5,7,0.714,3,1,4,3,1,0,1,2,16
267,Tre Jones,PG,21,SAS,37,1,269,37,78,0.474,3,5,0.6,34,73,0.466,0.494,17,19,0.895,8,13,21,39,8,0,13,13,94
268,Tyus Jones,PG,24,MEM,70,9,1222,178,413,0.431,45,140,0.321,133,273,0.487,0.485,41,45,0.911,21,119,140,259,64,6,48,31,442
269,DeAndre Jordan,C,32,BRK,57,43,1246,190,249,0.763,0,1,0,190,248,0.766,0.763,46,92,0.5,117,310,427,93,17,65,85,116,426
270,Cory Joseph,PG,29,TOT,63,13,1446,200,426,0.469,45,132,0.341,155,294,0.527,0.522,72,88,0.818,35,124,159,213,61,18,79,139,517
270,Cory Joseph,PG,29,SAC,44,2,944,111,250,0.444,31,94,0.33,80,156,0.513,0.506,36,47,0.766,25,74,99,108,39,9,44,98,289
270,Cory Joseph,PG,29,DET,19,11,502,89,176,0.506,14,38,0.368,75,138,0.543,0.545,36,41,0.878,10,50,60,105,22,9,35,41,228
271,Mfiondu Kabengele,PF,23,TOT,39,0,280,33,89,0.371,13,50,0.26,20,39,0.513,0.444,16,20,0.8,12,48,60,17,8,13,15,36,95
271,Mfiondu Kabengele,PF,23,LAC,23,0,94,9,32,0.281,4,18,0.222,5,14,0.357,0.344,5,6,0.833,1,13,14,5,2,3,6,18,27
271,Mfiondu Kabengele,PF,23,CLE,16,0,186,24,57,0.421,9,32,0.281,15,25,0.6,0.5,11,14,0.786,11,35,46,12,6,10,9,18,68
272,Frank Kaminsky,C,27,PHO,47,13,715,121,257,0.471,31,85,0.365,90,172,0.523,0.531,37,60,0.617,36,152,188,79,14,17,22,70,310
273,Luke Kennard,SG,24,LAC,63,17,1232,197,414,0.476,100,224,0.446,97,190,0.511,0.597,26,31,0.839,15,146,161,104,23,9,48,91,520
274,Louis King,SF,21,SAC,6,1,85,17,34,0.5,4,11,0.364,13,23,0.565,0.559,6,6,1,5,13,18,9,7,3,4,9,44
275,Maxi Kleber,PF,29,DAL,50,40,1341,116,275,0.422,87,212,0.41,29,63,0.46,0.58,34,37,0.919,47,213,260,68,24,35,30,105,353
276,Nathan Knight,PF,23,ATL,33,0,279,37,100,0.37,6,33,0.182,31,67,0.463,0.4,44,55,0.8,27,45,72,8,9,10,15,22,124
277,Kevin Knox,SF,21,NYK,42,0,464,56,143,0.392,35,89,0.393,21,54,0.389,0.514,16,20,0.8,10,51,61,19,12,6,17,37,163
278,John Konchar,SG,24,MEM,43,0,575,69,138,0.5,21,56,0.375,48,82,0.585,0.576,25,30,0.833,35,93,128,47,30,9,18,40,184
279,Furkan Korkmaz,SG,23,PHI,55,11,1062,170,424,0.401,101,269,0.375,69,155,0.445,0.52,60,82,0.732,17,96,113,82,49,9,46,64,501
280,Luke Kornet,C,25,TOT,31,2,348,44,101,0.436,15,59,0.254,29,42,0.69,0.51,3,6,0.5,14,53,67,24,4,32,7,20,106
280,Luke Kornet,C,25,CHI,13,0,94,9,27,0.333,6,23,0.261,3,4,0.75,0.444,2,4,0.5,1,14,15,4,2,7,1,1,26
280,Luke Kornet,C,25,BOS,18,2,254,35,74,0.473,9,36,0.25,26,38,0.684,0.534,1,2,0.5,13,39,52,20,2,25,6,19,80
281,Rodions Kurucs,SF-PF,22,TOT,21,0,125,11,32,0.344,6,21,0.286,5,11,0.455,0.438,3,4,0.75,5,18,23,10,9,4,13,16,31
281,Rodions Kurucs,PF,22,BRK,5,0,16,1,3,0.333,1,2,0.5,0,1,0,0.5,0,0,,0,3,3,2,0,0,0,1,3
281,Rodions Kurucs,SF,22,HOU,11,0,75,5,21,0.238,2,15,0.133,3,6,0.5,0.286,1,2,0.5,2,9,11,4,6,4,9,7,13
281,Rodions Kurucs,SF,22,MIL,5,0,34,5,8,0.625,3,4,0.75,2,4,0.5,0.813,2,2,1,3,6,9,4,3,0,4,8,15
282,Kyle Kuzma,SF,25,LAL,68,32,1954,335,757,0.443,137,380,0.361,198,377,0.525,0.533,67,97,0.691,108,309,417,127,35,41,113,121,874
283,Anthony Lamb,SF,23,HOU,24,3,415,46,118,0.39,23,71,0.324,23,47,0.489,0.487,18,21,0.857,27,43,70,23,6,5,19,34,133
284,Jeremy Lamb,SG,28,IND,36,8,765,120,276,0.435,52,128,0.406,68,148,0.459,0.529,71,75,0.947,25,106,131,53,34,23,22,72,363
285,Romeo Langford,SG,21,BOS,18,4,283,21,59,0.356,5,18,0.278,16,41,0.39,0.398,9,12,0.75,12,23,35,13,6,5,10,24,56
286,Zach LaVine,SG,25,CHI,58,58,2034,569,1123,0.507,200,477,0.419,369,646,0.571,0.596,253,298,0.849,36,253,289,282,46,27,203,138,1591
287,Jake Layman,SF,26,MIN,45,11,627,91,184,0.495,23,78,0.295,68,106,0.642,0.557,26,37,0.703,13,54,67,28,29,19,26,44,231
288,T.J. Leaf,PF,23,POR,7,0,35,5,10,0.5,0,0,,5,10,0.5,0.5,2,2,1,0,5,5,1,2,1,2,1,12
289,Jalen Lecque,PG,20,IND,4,0,12,1,9,0.111,0,1,0,1,8,0.125,0.111,3,3,1,2,3,5,2,0,0,0,0,5
290,Damion Lee,SG,28,GSW,57,1,1079,128,274,0.467,77,194,0.397,51,80,0.638,0.608,40,44,0.909,22,158,180,73,38,8,30,89,373
291,Saben Lee,PG,21,DET,48,7,781,99,210,0.471,8,23,0.348,91,187,0.487,0.49,61,89,0.685,20,77,97,174,32,13,55,76,267
292,Alex Len,C,27,TOT,64,42,979,171,278,0.615,8,25,0.32,163,253,0.644,0.629,73,116,0.629,78,182,260,49,20,64,55,127,423
292,Alex Len,C,27,TOR,7,2,76,5,10,0.5,3,6,0.5,2,4,0.5,0.65,3,6,0.5,0,11,11,3,1,6,8,10,16
292,Alex Len,C,27,WAS,57,40,903,166,268,0.619,5,19,0.263,161,249,0.647,0.629,70,110,0.636,78,171,249,46,19,58,47,117,407
293,Kawhi Leonard,SF,29,LAC,52,52,1773,465,908,0.512,101,254,0.398,364,654,0.557,0.568,261,295,0.885,55,282,337,269,81,21,105,82,1292
294,Meyers Leonard,C,28,MIA,3,2,29,3,7,0.429,3,7,0.429,0,0,,0.643,1,2,0.5,0,7,7,2,0,0,2,5,10
295,Caris LeVert,SG,26,TOT,47,39,1486,359,814,0.441,84,258,0.326,275,556,0.495,0.493,146,180,0.811,33,181,214,245,66,30,102,105,948
295,Caris LeVert,SG,26,BRK,12,4,334,87,200,0.435,22,63,0.349,65,137,0.474,0.49,26,34,0.765,10,42,52,72,13,6,26,20,222
295,Caris LeVert,SG,26,IND,35,35,1152,272,614,0.443,62,195,0.318,210,419,0.501,0.493,120,146,0.822,23,139,162,173,53,24,76,85,726
296,Kira Lewis Jr.,PG,19,NOP,54,0,904,130,337,0.386,40,120,0.333,90,217,0.415,0.445,43,51,0.843,12,59,71,124,38,10,34,88,343
297,Damian Lillard,PG,30,POR,67,67,2398,602,1334,0.451,275,704,0.391,327,630,0.519,0.554,449,484,0.928,32,251,283,505,62,17,203,102,1928
298,Nassir Little,PF,20,POR,48,2,640,78,167,0.467,28,80,0.35,50,87,0.575,0.551,36,45,0.8,32,96,128,23,5,13,18,51,220
299,Kevon Looney,C,24,GSW,61,34,1161,108,197,0.548,4,17,0.235,104,180,0.578,0.558,31,48,0.646,117,205,322,119,21,22,37,136,251
300,Brook Lopez,C,32,MIL,70,70,1902,322,640,0.503,95,281,0.338,227,359,0.632,0.577,120,142,0.845,104,243,347,50,40,103,64,149,859
301,Robin Lopez,C,32,WAS,71,9,1354,269,425,0.633,5,18,0.278,264,407,0.649,0.639,99,137,0.723,141,131,272,55,15,44,75,109,642
302,Didi Louzada,SF,21,NOP,3,0,56,3,13,0.231,2,8,0.25,1,5,0.2,0.308,0,0,,1,2,3,3,2,0,3,5,8
303,Kevin Love,PF,32,CLE,25,25,622,103,252,0.409,57,156,0.365,46,96,0.479,0.522,42,51,0.824,17,169,186,63,16,2,38,26,305
304,Kyle Lowry,PG,34,TOR,46,46,1601,260,596,0.436,131,331,0.396,129,265,0.487,0.546,140,160,0.875,35,212,247,338,45,14,126,143,791
305,Timothé Luwawu-Cabarrot,SF,25,BRK,58,7,1050,130,356,0.365,75,239,0.314,55,117,0.47,0.471,35,43,0.814,28,101,129,69,33,6,43,99,370
306,Trey Lyles,PF,25,SAS,23,9,358,43,90,0.478,14,40,0.35,29,50,0.58,0.556,15,23,0.652,9,77,86,14,6,1,6,13,115
307,Will Magnay,C,22,NOP,1,0,3,0,1,0,0,1,0,0,0,,0,0,0,,0,0,0,0,0,0,1,1,0
308,Thon Maker,C,23,CLE,8,0,76,10,18,0.556,0,2,0,10,16,0.625,0.556,10,11,0.909,8,10,18,4,2,4,3,7,30
309,Théo Maledon,PG,19,OKC,65,49,1778,226,614,0.368,105,313,0.335,121,301,0.402,0.454,101,135,0.748,25,186,211,227,56,11,141,126,658
310,Karim Mané,PG,20,ORL,10,0,88,3,13,0.231,1,2,0.5,2,11,0.182,0.269,4,5,0.8,1,13,14,4,0,2,3,10,11
311,Terance Mann,SG,24,LAC,67,10,1263,178,350,0.509,38,91,0.418,140,259,0.541,0.563,78,94,0.83,56,186,242,104,29,13,40,126,472
312,Nico Mannion,PG,19,GSW,30,1,364,39,114,0.342,22,60,0.367,17,54,0.315,0.439,23,28,0.821,6,40,46,70,16,1,31,29,123
313,Boban Marjanović,C,32,DAL,33,3,271,62,122,0.508,1,8,0.125,61,114,0.535,0.512,31,38,0.816,47,81,128,10,2,6,12,29,156
314,Lauri Markkanen,PF,23,CHI,51,26,1317,250,521,0.48,119,296,0.402,131,225,0.582,0.594,76,92,0.826,35,233,268,45,26,15,52,75,695
315,Naji Marshall,SF,23,NOP,32,10,700,82,209,0.392,29,83,0.349,53,126,0.421,0.462,53,75,0.707,15,133,148,88,26,10,38,58,246
316,Caleb Martin,SF,25,CHO,53,3,818,96,256,0.375,31,125,0.248,65,131,0.496,0.436,41,64,0.641,31,110,141,67,37,12,33,62,264
317,Cody Martin,SF,25,CHO,52,10,849,83,188,0.441,16,58,0.276,67,130,0.515,0.484,25,43,0.581,52,109,161,86,37,12,40,52,207
318,Jeremiah Martin,PG,24,CLE,9,0,75,9,33,0.273,3,12,0.25,6,21,0.286,0.318,1,5,0.2,2,5,7,4,5,2,6,1,22
319,Kelan Martin,SF,25,IND,35,0,322,62,138,0.449,24,60,0.4,38,78,0.487,0.536,9,10,0.9,18,60,78,17,10,10,16,35,157
320,Kenyon Martin Jr.,SF,20,HOU,45,8,1068,162,318,0.509,35,96,0.365,127,222,0.572,0.564,60,84,0.714,73,169,242,48,30,41,38,89,419
321,Frank Mason III,PG,26,ORL,4,1,79,9,24,0.375,2,5,0.4,7,19,0.368,0.417,5,7,0.714,3,9,12,12,0,0,5,7,25
322,Garrison Mathews,SG,24,WAS,64,24,1038,97,237,0.409,76,198,0.384,21,39,0.538,0.57,84,95,0.884,16,71,87,26,29,7,10,106,354
323,Dakota Mathias,SG,25,PHI,8,2,123,19,48,0.396,8,26,0.308,11,22,0.5,0.479,2,6,0.333,1,6,7,13,1,3,1,7,48
324,Wesley Matthews,SG,34,LAL,58,10,1130,89,252,0.353,66,197,0.335,23,55,0.418,0.484,35,41,0.854,20,73,93,54,38,17,26,80,279
325,Tyrese Maxey,SG,20,PHI,61,8,935,198,429,0.462,31,103,0.301,167,326,0.512,0.498,61,70,0.871,11,93,104,120,26,13,41,79,488
326,Skylar Mays,SG,23,ATL,33,0,269,44,98,0.449,14,40,0.35,30,58,0.517,0.52,22,25,0.88,10,25,35,30,14,2,9,15,124
327,Patrick McCaw,SF,25,TOR,5,0,33,1,1,1,0,0,,1,1,1,1,3,3,1,1,2,3,4,2,0,0,6,5
328,CJ McCollum,SG,29,POR,47,47,1600,405,884,0.458,169,420,0.402,236,464,0.509,0.554,108,133,0.812,30,155,185,223,44,21,65,87,1087
329,T.J. McConnell,PG,28,IND,69,3,1796,274,490,0.559,15,48,0.313,259,442,0.586,0.574,33,48,0.688,55,201,256,456,128,23,135,113,596
330,Jaden McDaniels,PF,20,MIN,63,27,1511,164,367,0.447,72,198,0.364,92,169,0.544,0.545,27,45,0.6,52,180,232,71,35,60,47,172,427
331,Jalen McDaniels,SF,23,CHO,47,18,904,133,284,0.468,35,105,0.333,98,179,0.547,0.53,45,64,0.703,45,124,169,53,28,19,45,95,346
332,Doug McDermott,PF,29,IND,66,29,1619,354,665,0.532,111,286,0.388,243,379,0.641,0.616,80,98,0.816,60,161,221,85,20,6,53,117,899
333,Sean McDermott,SF,24,MEM,18,0,158,13,33,0.394,5,22,0.227,8,11,0.727,0.47,8,8,1,6,13,19,4,2,3,4,8,39
334,JaVale McGee,C,33,TOT,46,2,678,144,282,0.511,5,24,0.208,139,258,0.539,0.52,44,67,0.657,77,162,239,39,19,54,60,121,337
334,JaVale McGee,C,33,CLE,33,1,503,112,215,0.521,5,20,0.25,107,195,0.549,0.533,36,55,0.655,54,116,170,33,16,40,45,80,265
334,JaVale McGee,C,33,DEN,13,1,175,32,67,0.478,0,4,0,32,63,0.508,0.478,8,12,0.667,23,46,69,6,3,14,15,41,72
335,Rodney McGruder,SG,29,DET,16,2,194,37,70,0.529,11,24,0.458,26,46,0.565,0.607,6,8,0.75,8,14,22,16,8,1,7,12,91
336,Alfonzo McKinnie,SF,28,LAL,39,0,258,48,93,0.516,16,39,0.41,32,54,0.593,0.602,10,18,0.556,22,32,54,6,7,0,5,26,122
337,Jordan McLaughlin,PG,24,MIN,51,2,938,100,242,0.413,33,92,0.359,67,150,0.447,0.481,23,30,0.767,21,87,108,193,51,6,51,44,256
338,Ben McLemore,SG,27,TOT,53,5,905,135,365,0.37,97,280,0.346,38,85,0.447,0.503,39,53,0.736,15,85,100,39,23,9,42,88,406
338,Ben McLemore,SG,27,HOU,32,4,537,80,224,0.357,55,166,0.331,25,58,0.431,0.48,23,32,0.719,11,55,66,28,20,3,28,51,238
338,Ben McLemore,SG,27,LAL,21,1,368,55,141,0.39,42,114,0.368,13,27,0.481,0.539,16,21,0.762,4,30,34,11,3,6,14,37,168
339,Nicolò Melli,PF,30,TOT,45,4,566,46,141,0.326,23,85,0.271,23,56,0.411,0.408,19,25,0.76,29,93,122,44,14,3,12,58,134
339,Nicolò Melli,PF,30,NOP,22,0,241,15,59,0.254,7,37,0.189,8,22,0.364,0.314,6,7,0.857,12,45,57,25,9,1,7,28,43
339,Nicolò Melli,PF,30,DAL,23,4,325,31,82,0.378,16,48,0.333,15,34,0.441,0.476,13,18,0.722,17,48,65,19,5,2,5,30,91
340,De'Anthony Melton,PG,22,MEM,52,1,1045,172,393,0.438,87,211,0.412,85,182,0.467,0.548,41,51,0.804,30,131,161,132,60,31,66,85,472
341,Sam Merrill,SG,24,MIL,30,2,233,32,72,0.444,21,47,0.447,11,25,0.44,0.59,4,4,1,6,24,30,21,8,1,10,17,89
342,Chimezie Metu,C,23,SAC,36,6,488,91,179,0.508,13,37,0.351,78,142,0.549,0.545,31,43,0.721,31,81,112,28,14,18,29,59,226
343,Khris Middleton,SF,29,MIL,68,68,2269,511,1074,0.476,151,365,0.414,360,709,0.508,0.546,212,236,0.898,54,352,406,370,74,9,178,160,1385
344,Darius Miller,SF,30,OKC,18,0,197,22,48,0.458,17,42,0.405,5,6,0.833,0.635,12,12,1,2,22,24,21,13,5,8,13,73
345,Patty Mills,PG,32,SAS,68,1,1685,252,611,0.412,161,429,0.375,91,182,0.5,0.544,71,78,0.91,18,98,116,162,42,3,66,81,736
346,Paul Millsap,PF,35,DEN,56,36,1162,191,401,0.476,49,143,0.343,142,258,0.55,0.537,71,98,0.724,76,186,262,98,51,36,51,111,502
347,Shake Milton,SG,24,PHI,63,4,1461,300,667,0.45,71,203,0.35,229,464,0.494,0.503,146,176,0.83,33,115,148,193,39,18,103,130,817
348,Donovan Mitchell,PG,24,UTA,53,53,1771,478,1091,0.438,178,461,0.386,300,630,0.476,0.52,267,316,0.845,50,185,235,277,52,15,147,117,1401
349,Adam Mokoka,SG,22,CHI,14,0,56,7,19,0.368,1,10,0.1,6,9,0.667,0.395,0,1,0,1,4,5,5,2,1,5,5,15
350,Malik Monk,SG,22,CHO,42,0,878,173,399,0.434,85,212,0.401,88,187,0.471,0.54,59,72,0.819,14,87,101,87,19,4,55,47,490
351,E'Twaun Moore,SG,31,PHO,27,1,389,55,121,0.455,11,35,0.314,44,86,0.512,0.5,12,14,0.857,14,31,45,40,15,5,23,32,133
352,Ja Morant,PG,21,MEM,63,63,2053,430,957,0.449,73,241,0.303,357,716,0.499,0.487,271,372,0.728,59,193,252,465,57,13,203,87,1204
353,Juwan Morgan,PF,23,UTA,29,0,147,14,30,0.467,4,13,0.308,10,17,0.588,0.533,3,7,0.429,9,19,28,9,4,1,4,21,35
354,Marcus Morris,PF,31,LAC,57,29,1502,276,584,0.473,140,296,0.473,136,288,0.472,0.592,73,89,0.82,35,199,234,58,34,15,57,117,765
355,Markieff Morris,PF,31,LAL,61,27,1200,153,378,0.405,65,209,0.311,88,169,0.521,0.491,36,50,0.72,48,218,266,73,22,19,54,105,407
356,Monte Morris,PG,25,DEN,47,13,1196,186,387,0.481,51,134,0.381,135,253,0.534,0.547,58,73,0.795,11,85,96,150,34,13,34,48,481
357,Mychal Mulder,PG,26,GSW,60,6,766,119,265,0.449,85,214,0.397,34,51,0.667,0.609,14,22,0.636,8,52,60,26,12,12,16,56,337
358,Dejounte Murray,PG,24,SAS,67,67,2139,441,974,0.453,63,199,0.317,378,775,0.488,0.485,106,134,0.791,58,415,473,363,101,7,117,135,1051
359,Jamal Murray,PG,23,DEN,48,48,1704,378,792,0.477,129,316,0.408,249,476,0.523,0.559,133,153,0.869,37,157,194,231,64,13,108,95,1018
360,Mike Muscala,C,29,OKC,35,0,645,119,267,0.446,68,184,0.37,51,83,0.614,0.573,33,36,0.917,19,113,132,28,8,11,21,54,339
361,Svi Mykhailiuk,SF,23,TOT,66,14,1324,208,506,0.411,105,314,0.334,103,192,0.536,0.515,38,50,0.76,24,139,163,110,51,12,88,63,559
361,Svi Mykhailiuk,SF,23,DET,36,5,634,84,223,0.377,57,171,0.333,27,52,0.519,0.504,24,30,0.8,11,63,74,57,27,6,39,33,249
361,Svi Mykhailiuk,SF,23,OKC,30,9,690,124,283,0.438,48,143,0.336,76,140,0.543,0.523,14,20,0.7,13,76,89,53,24,6,49,30,310
362,Abdel Nader,SF,27,PHO,24,0,355,57,116,0.491,18,43,0.419,39,73,0.534,0.569,28,37,0.757,7,55,62,19,10,9,19,34,160
363,Larry Nance Jr.,PF,28,CLE,35,27,1091,128,272,0.471,41,114,0.36,87,158,0.551,0.546,30,49,0.612,54,181,235,107,61,17,55,72,327
364,Aaron Nesmith,SF,21,BOS,46,1,669,78,178,0.438,40,108,0.37,38,70,0.543,0.551,22,28,0.786,28,99,127,23,15,9,23,87,218
365,Raul Neto,PG,28,WAS,64,22,1403,209,447,0.468,64,164,0.39,145,283,0.512,0.539,75,85,0.882,28,128,156,146,73,6,53,109,557
366,Georges Niang,PF,27,UTA,72,10,1154,177,405,0.437,124,292,0.425,53,113,0.469,0.59,22,23,0.957,28,148,176,59,25,8,51,116,500
367,Zeke Nnaji,PF,20,DEN,42,1,397,50,104,0.481,24,59,0.407,26,45,0.578,0.596,12,15,0.8,14,51,65,10,8,4,7,29,136
368,Nerlens Noel,C,26,NYK,64,41,1547,137,223,0.614,0,3,0,137,220,0.623,0.614,50,70,0.714,142,266,408,46,70,141,65,176,324
369,Jaylen Nowell,SG,21,MIN,42,0,759,142,335,0.424,50,150,0.333,92,185,0.497,0.499,45,55,0.818,19,76,95,62,22,12,28,72,379
370,Frank Ntilikina,PG,22,NYK,33,4,322,29,79,0.367,23,48,0.479,6,31,0.194,0.513,8,18,0.444,6,25,31,19,18,4,11,45,89
371,Kendrick Nunn,PG,25,MIA,56,44,1650,319,658,0.485,122,320,0.381,197,338,0.583,0.578,56,60,0.933,21,158,179,148,52,14,80,108,816
372,James Nunnally,SF,30,NOP,9,0,48,5,13,0.385,4,12,0.333,1,1,1,0.538,1,2,0.5,2,7,9,3,0,0,2,1,15
373,Jusuf Nurkić,C,26,POR,37,37,880,171,333,0.514,12,30,0.4,159,303,0.525,0.532,70,113,0.619,86,246,332,125,38,39,73,103,424
374,David Nwaba,SF,28,HOU,30,9,679,106,218,0.486,17,63,0.27,89,155,0.574,0.525,47,68,0.691,40,78,118,31,30,21,17,60,276
375,Jordan Nwora,SF,22,MIL,30,2,274,62,135,0.459,28,62,0.452,34,73,0.466,0.563,19,25,0.76,9,51,60,7,16,7,24,22,171
376,Royce O'Neale,SF,27,UTA,71,71,2241,175,394,0.444,107,278,0.385,68,116,0.586,0.58,39,46,0.848,88,397,485,181,57,32,83,182,496
377,Semi Ojeleye,PF,26,BOS,56,15,950,89,221,0.403,58,158,0.367,31,63,0.492,0.534,24,32,0.75,31,116,147,37,17,0,21,56,260
378,Jahlil Okafor,C,25,DET,27,2,347,63,102,0.618,2,9,0.222,61,93,0.656,0.627,17,24,0.708,23,43,66,13,6,5,21,39,145
379,Chuma Okeke,PF,22,ORL,45,19,1133,135,324,0.417,49,141,0.348,86,183,0.47,0.492,30,40,0.75,42,139,181,101,48,22,38,48,349
380,Josh Okogie,SG,22,MIN,59,37,1197,102,254,0.402,29,108,0.269,73,146,0.5,0.459,83,108,0.769,63,93,156,63,54,28,43,123,316
381,Onyeka Okongwu,C,20,ATL,50,4,601,96,149,0.644,0,3,0,96,146,0.658,0.644,36,57,0.632,62,101,163,18,23,33,29,100,228
382,Isaac Okoro,SG,20,CLE,67,67,2173,235,559,0.42,62,214,0.29,173,345,0.501,0.476,114,157,0.726,68,138,206,128,62,24,86,185,646
383,KZ Okpala,PF,21,MIA,37,9,447,36,96,0.375,12,50,0.24,24,46,0.522,0.438,8,15,0.533,21,47,68,19,10,11,15,59,92
384,Victor Oladipo,SG,28,TOT,33,33,1080,235,576,0.408,78,239,0.326,157,337,0.466,0.476,104,138,0.754,12,148,160,151,46,14,83,81,652
384,Victor Oladipo,SG,28,IND,9,9,300,64,152,0.421,25,69,0.362,39,83,0.47,0.503,27,37,0.73,1,50,51,38,15,2,18,23,180
384,Victor Oladipo,SG,28,HOU,20,20,669,155,381,0.407,49,153,0.32,106,228,0.465,0.471,65,83,0.783,8,87,95,99,24,10,51,45,424
384,Victor Oladipo,SG,28,MIA,4,4,111,16,43,0.372,4,17,0.235,12,26,0.462,0.419,12,18,0.667,3,11,14,14,7,2,14,13,48
385,Cameron Oliver,SF,24,HOU,4,0,87,19,33,0.576,4,13,0.308,15,20,0.75,0.636,1,4,0.25,5,16,21,5,2,4,3,11,43
386,Kelly Olynyk,C-PF,29,TOT,70,62,1997,337,697,0.484,126,368,0.342,211,329,0.641,0.574,145,175,0.829,87,402,489,203,79,42,126,207,945
386,Kelly Olynyk,C,29,MIA,43,38,1157,162,376,0.431,77,243,0.317,85,133,0.639,0.533,31,40,0.775,44,217,261,91,40,26,55,123,432
386,Kelly Olynyk,PF,29,HOU,27,24,840,175,321,0.545,49,125,0.392,126,196,0.643,0.621,114,135,0.844,43,185,228,112,39,16,71,84,513
387,Miye Oni,SG,23,UTA,54,0,519,35,99,0.354,30,88,0.341,5,11,0.455,0.505,5,6,0.833,23,61,84,28,11,8,16,61,105
